amniocentesis|n|(သေႏၶသားေလာင္းအေျခအေန သိႏိုင္ရန္) ေရျမႊာဆန္းစစ္မႈ။||
AM|abbr|(radio) Amplitude Modulation. ေရဒီယိုလႈိင္း၏ အေစာက္ပမာဏကို ျပဳျပင္ေပးျခင္းျဖင့္ လႊင့္ထုတ္ သည့္ အသံလႊင့္နည္း။ (US) မဟာဝိဇၨာဘြဲ႔။||
AM|abbr|နံနက္ပိုင္း။||
amalgam|n|ေႏွာဖက္မႈ။ ေရာစပ္မႈ။ (သြားေပါက္ဖာရန္ သြားဆရာဝန္မ်ား သံုးေသာ) ျပဒါးသတၱဳစပ္။||
amalgamate|v|ေပါင္းသည္။||
amalgamation|n|ေရာေႏွာ ေပါင္းစပ္မႈ။||
amass|v|စုေဆာင္းသည္။||
amateur|n|အေပ်ာ္တမ္း(အားကစား)သမား၊ (ဂီတ)ပညာရွင္ စသည္။ မကြၽမ္းက်င္ေသးသူ။ အေတြ႔ အၾကံဳ ႏုေသးသူ။ လက္သင္။||
amateurish|adj|မကြၽမ္းက်င္ေသာ။ လက္ရာမေျမာက္ေသာ။||
amateurishly|adv|မကြၽမ္းမက်င္။||
amateurism|n|မကြၽမ္းမက်င္ျခင္း။||
amaze|v|အံ့အားသင့္ေစသည္။ တအံ့တၾသျဖစ္ရသည္။||
amazed|adv|အံ့ၾသေသာ။ အံ့အားသင့္ [ေသာ]။ မယံုႏိုင္ေလာက္ေအာင္ျဖစ္ရ [ေသာ]။||
amazement|n|အံ့ၾသျခင္း။ အံ့အားသင့္ [ျခင္း]။ မယံုႏိုင္ေလာက္ေအာင္ျဖစ္ရ [ျခင္း]။||
amazing|adj|အံ့ၾသဖြယ္ရာ။ အံ့အားသင့္ [ေသာ]။ မယံုၾကည္ႏိုင္စရာ ေကာင္းေသာ။||
amazingly|adv|မယံုၾကည္ႏိုင္ေလာက္ေအာင္ပင္။ အံ့ၾသ ဖြယ္ရာ ေကာင္းသည္မွာ။||
amazon|n|ေဒါင္ေကာင္း၍ သန္စြမ္းေသာ မိန္းမ။ ယုဒၶကာမိနီ။||
ambassador|n|သံအမတ္။||
ambassadorial|adj|သံအမတ္ ႏွင့္ သက္ဆိုင္ေသာ။||
amber|n|ပယင္း။ ပယင္းေရာင္။||
ambience|n|ဝန္းက်င္ ဓေလ့စ႐ိုက္။||
ambiance|n|ဝန္းက်င္ ဓေလ့စ႐ိုက္။||
ambidextrous|adj|လက္ႏွစ္ဖက္စလံုး ကၽြမ္းကၽြမ္းက်င္က်င္အသံုးျပဳေသာ။||
ambient|adj|ဝန္းက်င္။||
ambiguity|n|အနက္ ေထြျပားျခင္း။ လိုသလို ေကာက္ယူႏိုင္ျခင္း။ အဓိပၸာယ္ ႏွစ္ခြထြက္ေသာ စကား။ မေရ ရာျခင္း။ မျပတ္သားျခင္း။||
ambiguous|adj|ဒြိဟျဖစ္ေစေသာ။ အနက္ မျပတ္သားေသာ။ မေရရာေသာ။ မျပတ္သားေသာ။||
ambiguously|adv|ဟိုလိုလိုသည္လိုလို။ မေရမရာ။||
ambit|n|ပိုင္နက္။ အပိုင္။ ခြင္။||
ambition|n|ျပင္းျပေသာ ဆႏၵ၊ ရည္မွန္းခ်က္။ တိုးတက္ႀကီးပြားလိုစိတ္။||
ambitious|adj|ရည္မွန္းခ်က္ႀကီးေသာ။ အလွမ္း က်ယ္လြန္းေသာ။||
ambitiously|adv|ရည္မွန္းခ်က္ႀကီးေသာ။ အလွမ္း က်ယ္လြန္းေသာ။||
ambivalent|adj|အျမင္၊ စိတ္ ခံစားမႈ အေကာင္းႏွင့္အဆိုး ဒြန္တြဲေနေသာ။ စိတ္ႏွစ္ခြျဖစ္ေသာ။ မတင္မက်ျဖစ္ေသာ။||
ambivalence|n|ယင္းသို႔ျဖစ္ျခင္း။||
amble|v|စိမ္ေျပနေျပေလွ်ာက္သည္၊လွမ္းသည္၊ သြားသည္။||
ambulance|n|သူနာတင္ယာဥ္။ လူနာတင္ကား။||
ambulance chaser|n|မေတာ္တဆ ထိခိုက္မႈျဖစ္လွ်င္ ေလ်ာ္ေၾကးအတြက္ တရားစြဲရန္ ဆြေပးသူေရွ႔ေန။||
ambulanceman|n|သူနာတင္ယာဥ္ႏွင့္လိုက္ပါၿပီး ေရွးဦးသူနာ ျပဳစုေပးသူ။ သူနာတင္ယာဥ္လုပ္သား။||
ambulancemen|n|သူနာတင္ယာဥ္ႏွင့္လိုက္ပါၿပီး ေရွးဦးသူနာ ျပဳစုေပးသူမ်ား။ သူနာတင္ယာဥ္လုပ္သားမ်ား။||
ambulance worker|n|သူနာတင္ယာဥ္ႏွင့္လိုက္ပါၿပီး ေရွးဦးသူနာ ျပဳစုေပးသူမ်ား။ သူနာတင္ယာဥ္လုပ္သားမ်ား။||
ambuscade|n|vt|ေခ်ာင္းေျမာင္းတိုက္ခိုက္ျခင္း။ ခ်ဳံခိုတိုက္ျခင္း။||
ambush|n|ေခ်ာင္းေျမာင္းတိုက္ခိုက္ျခင္း။ ခ်ဳံခိုတိုက္ျခင္း။||
ambush|v|ခ်ဳံခိုတိုက္ခိုက္သည္။ ေခ်ာင္းေျမာင္း တိုက္ခိုက္သည္။ အလစ္ ဖမ္းသည္။||
ameliorate|v|ပိုမိုေကာင္းမြန္ေစသည္။||
amelioration|n|ပိုမိုေကာင္းမြန္ေစျခင္း။||
amen|interj|မွန္ပါေစေသာ္။ အာမင္။||
amenable|adj|လိုလိုလားလား လက္ခံ တတ္ေသာ။ (တစ္စံုတစ္ရာျပဳလုပ္ႏိုင္ရန္)အလားအလာရွိေသာ၊ ေရွာေရွာ ရွဴရွဴရွိေသာ။||
amend|v|ျပင္ဆင္ခ်က္ထုတ္သည္။ ျပဳျပင္သည္။ အမွား ျပင္သည္။||
amendment|n|ျပင္ဆင္ခ်က္။ ျပင္ဆင္ ျဖည့္စြက္ခ်က္။ ျပင္ဆင္ျခင္း။||
amends|n|ျပင္ဆင္ခ်က္။ ျပင္ဆင္ ျဖည့္စြက္ခ်က္။ ျပင္ဆင္ျခင္း။||
amenity|n|သာယာ အဆင္ေျပမႈ။ သာယာပံု။||
American|adj|အထူးသျဖင့္ အေမရိကန္ ျပည္ေထာင္စု ႏွင့္ သက္ဆိုင္ေသာ။ ေျမာက္အေမရိက (သို႔) ေတာင္အေမရိက ႏွင့္ သက္ဆိုင္ေသာ။ အေမရိကန္။||
American|n|အေမရိကန္လူမ်ဳိး။ အေမရိကန္ႏိုင္ငံသား။ (also American English) အေမရိကန္သံုး အဂၤလိပ္စကား။||
Americana|n|အေမရိကန္ျပည္ေထာင္စု ႏွင့္ ပတ္သက္ေသာ အရာခပ္သိမ္း။||
American football|n|(Brit) အားကစားသမား (၁၁) ဦးစီပါေသာ အသင္းႏွစ္သင္းတို႔က ဘဲဥပံုေဘာလံုးကို ပိုက္၍ လည္းေကာင္း၊ အခ်င္းခ်င္းပစ္ေပး၍လည္းေကာင္း အျခား တစ္ဖက္သို႔ သယ္ေျပးကာ ယွဥ္ၿပိဳင္ရေသာ ေဘာလံုးကစားနည္း တစ္မ်ဳိး။||
Americanism|n|(ၿဗိတိန္စံ အသံုးအႏႈန္းႏွင့္ ျခားနားေသာ) အေမရိကန္အသံုးအႏႈန္း။||
Americanize|v|အေမရိကန္ပံုဖမ္းသည္။||
Americanise|v|အေမရိကန္ပံုဖမ္းသည္။||
amethyst|n|နီလာခရမ္း။ ေက်ာက္ခရမ္းပြင့္။ သီဟိုဠ္နီလာ။||
amiable|adj|ေဖာ္ေရြတတ္ေသာ။ ၾကည္သာေသာ။||
amiably|adv|ေဖာ္ေဖာ္ေရြေရြ။||
amiability|n|ေဖာ္ေရြျခင္း။||
amicable|adj|ခ်စ္ၾကည္ေသာ။ အခင္မင္မပ်က္ေသာ။||
amicably|adv|အခင္မင္မပ်က္။ ခင္ခင္မင္မင္။||
amid|prep|အလယ္တြင္။ အၾကားတြင္။ ၾကားထဲတြင္။||
amidships|adv|သေဘၤာနံပါးအလယ္။||
amidst|preps|အလယ္တြင္။ အၾကားတြင္။ ၾကားထဲတြင္။||
amino acid|n|(biology or chemistry) လူ၊ တိရစၦာန္တို႔တြင္ အသားဓာတ္ျဖစ္ေစေသာ အမီႏိုအက္စစ္။||
amiss|adj|မွားေသာ။ တလြဲ။||
amiss|adv|မွားေသာ။ တလြဲ။||
amity|n|ခ်စ္ၾကည္မႈ။||
ammo|n|ခဲယမ္းမီးေက်ာက္။ ခဲယမ္း။ က်ည္။||
ammonia|n|အမိုးနီးယားဓာတ္ေငြ႔။||
ammunition|n|ခဲယမ္းမီးေက်ာက္။ ခဲယမ္း။ က်ည္။ ေျပာကြက္။||
amnesia|n|အတိတ္ေမ့ေရာဂါ။ မွတ္ဉာဏ္ကြယ္ျခင္း။||
amnesty|n|လြတ္ၿငိမ္းခ်မ္းသာခြင့္။ လြတ္ၿငိမ္းခ်မ္းသာခြင့္ကာလ။||
amoeba|n|အမီးဗား။||
amoebas|n|အမီးဗားမ်ား။||
amoebae|n|အမီးဗားမ်ား။||
amok|adv|ေဒါသတႀကီးေလွ်ာက္ရမ္းသည္။||
among|prep|ၾကားထဲတြင္။ အၾကားတြင္။ ထဲတြင္။ ထဲမွာ။ အမ်ားထဲတြင္။||
amongst|prep|ၾကားထဲတြင္။ အၾကားတြင္။ ထဲတြင္။ ထဲမွာ။ အမ်ားထဲတြင္။||
amoral|adj|ကိုယ္က်င့္တရား ကင္းမဲ့ေသာ။||
amorous|adj|တဏွာရာဂ ျပည့္လွ်မ္းေသာ၊ တက္ၾကြေသာ။ ရမၼက္လွ်မ္းေသာ။ (ဗန္း) ဏွာကန္ [ေသာ]။||
amorously|adv|တဏွာရာဂ ျပည့္လွ်မ္းေသာ၊ တက္ၾကြေသာ။ ရမၼက္လွ်မ္းေသာ။ (ဗန္း) ဏွာကန္ [ေသာ]။||
amorphous|adj|႐ုပ္လံုးသဏၭာန္ မပီျပင္ေသာ။ ပံုဖမ္း မရေသာ။ ပံုေဆာင္မဲ့။||
amortize|v|(အေၾကြး ကို) အရစ္က် ျပန္ဆပ္သည္။||
amortise|v|(အေၾကြး ကို) အရစ္က် ျပန္ဆပ္သည္။||
amount|n|ေငြပမာဏ။ ပမာဏ။ အတိုင္းအတာ။||
amour|n|(အထူးသျဖင့္ တိတ္တိတ္ပုန္း) အခ်စ္ကိစၥ။||
amour propre|n|သိကၡာ။||
amp|n|အမ္ပီယာ။ အသံခ်ဲ႔စက္။||
ampere|n|အမ္ပီယာ။ အသံခ်ဲ႔စက္။||
ampersand|n|`ႏွင့္´ဟု အဓိပၸာယ္ရေသာ သေကၤတ။ "&" ။||
amphetamine|n|(medical) စိတ္ၾကြေဆး။||
amphibian|n|ကုန္းေန ေရေနသတၱဝါ။ ကုန္းတစ္ပိုင္း ေရတစ္ပိုင္းသတၱဝါ။||
amphibious|adj|ကုန္း၊ ေရႏွစ္သြယ္ (စစ္ဆင္မႈ စသည္)။ ကုန္း၊ ေရ ႏွစ္သြယ္(ယာဥ္)။ ကုန္းေနေရေန (သတၱဝါ)။||
amphitheatre|n|(ေရွးဂရိႏွင့္ေရာမေခတ္) အမိုးမဲ့ပြဲၾကည့္စင္ဝိုင္း။ အလားတူ ထိုင္ခံုတန္းမ်ားဆင့္ထားေသာ ေဟာေျပာခန္းမ။||
ample|adj|လံုေလာက္ေသာ (သို႔) ပိုလွ်ံေသာ။ ႀကီးမားေသာ။ ထြားေသာ။ ဧရာမ။||
amply|adv|ျပည့္စံုလံုေလာက္စြာ။ လိုသည္ ထက္မက။ အလွ်ံပယ္။||
amplify|v|(အထူးသျဖင့္ အသံ ကို)ခ်ဲ႔သည္။ (အား)ျမႇင့္သည္။ ခ်ဲ႔ထြင္ရွင္းျပသည္။||
amplification|n|ခ်ဲ႔ျခင္း။||
amplifier|n|အသံခ်ဲ႔စက္။ ခ်ဲ႔စက္။||
amplitude|n|(techn) (အသံလႈိင္း၊ ေရဒီယိုလႈိင္းတို႔၏) လႊဲခြင္။ (fml) ႀကီးမားမႈ။ က်ယ္ျပန္႔မႈ။ ခြင္အလႊံ႔။||
ampoule|n|(medical) (ထိုးေဆး)ေလလံုပုလင္း။||
ampule|n|(medical) (ထိုးေဆး)ေလလံုပုလင္း။||
amputate|v|ျဖတ္ေတာက္(ကုသ)သည္။||
amputation|n|ျဖတ္ေတာက္ျခင္း။||
amulet|n|(ခါးလွည့္၊ လက္ဖြဲ႔ စသည့္)အေဆာင္။||
amuse|v|သေဘာက်သည္။ ျပံဳးရယ္ေစသည္။ အပ်င္းေျပေစသည္။||
amusement|n|ေဖ်ာ္ေျဖမႈ။ ရယ္ခ်င္စိတ္။ ရယ္ရျခင္း။ ရယ္စရာ။ အေပ်ာ္အျပက္။||
amusement arcade|n|(Brit) တီဗြီကစားနည္း စသည့္ စက္ခံုမ်ားတြင္ အခေၾကးေပး၍ ကစားႏိုင္ေသာ ကစား႐ံု။||
amusement park|n|ခ်ား၊ ရဟတ္ စသည္ အပ်င္းေျပစီးနင္းႏိုင္ေသာ အပန္းေျဖဥယ်ာဥ္။||
amusing|adj|ရယ္စရာ။ ရႊင္ျမဴးဖြယ္ရာ။||
amusement arcade|n|(Brit) တီဗီကစားနည္း စသည့္ စက္ခံုမ်ားတြင္ အခေၾကးေပး၍ ကစားႏိုင္ေသာ ကစား႐ံု။||
