snapdragon|n|က်ားပါးစပ္ပန္း။||
snare|n|ညႊတ္။ ေက်ာ့ကြင္း။ ဥညႊတ္ကြင္း။ ေက်ာ့ကြင္း။ ေထာင္ေခ်ာက္။ ညႊတ္ေထာင္သည္။ ေထာင္ဖမ္းသည္။ စနဲဗုံ။ ေအာက္မ်က္ႏွာဝတြင္သတၱဳႀကိဳးမ်ားတန္းထားသျဖင့္ေခါက္ၿပီးေနာက္အသံဆက္လက္တုန္ယင္ထြက္သည္။||
snarl|v|ေခြးစသည္အစြယ္ျပၿပီးမာန္ဖီသည္။ ဟိန္းေဟာက္သည္။ ေဒါသျဖင့္ႀကိမ္းဝါးသည္။ မာန္ဖီျခင္း။ ဟိန္းျခင္း။ ေထြးျခင္း။ ႐ႈပ္ျခင္း။ ထုံးျခင္း။ အေထြးအလုံး။ အထုံး။ လုံးေထြးသြားသည္။ ႐ႈပ္ကုန္သည္။ ပိတ္ဆို႔ကုန္သည္။ ယာဥ္ေၾကာပိတ္ဆို႔မႈ။||
snatch|v|ကဆတ္ခနဲဆဲြယူသည္၊လုယူသည္။ ခဆတ္ခနဲဖယ္သည္၊႐ုပ္သည္။ အလစ္သုတ္သည္။ အေျခအေနေပးခိုက္အခြင့္အေရးကိုအျမန္ရယူသည္။ တစ္နာရီေလာက္လုအိပ္လိုက္တယ္။ သူတို႔ပဲြၿပီးခါနီးမွေတ့ၿပီးအလုအယက္ႀကိဳးစားအႏိုင္ယူလိုက္ၾကတယ္။ ကသီခ်င္း၊စကား၊႐ုပ္ရွင္စသည္အပိုင္းအစ။ ခထံု႔ပိုင္းထံု႔ပိုင္း။ ဆတ္ခနဲယူငင္ျခင္း။ လက္ျဖင့္လွမ္းယူသည္။ အရယူရန္သဲသဲမဲမဲႀကဳိးပမ္းသည္။ လုေျပးသူ။ အလစ္သုတ္သမား။||
snazzy|adj|အဝတ္အထည္စသည္ေခတ္မီသပ္ရပ္လွပေသာ။||
sneak|v|ကေလးခ်င္းခ်င္းအေၾကာင္းလူႀကီးထံ၌အတို႔အေထာင္လုပ္သည္။ ခိုးယူသည္။ ခိုးလုပ္သည္။ ခိုးေၾကာင္ခိုးဝွက္ဝင္လာသည္၊လစ္သြားသည္စသည္။ သတၱိေၾကာင္သည့္ကလိမ္ကက်စ္အထူးသျဖင့္အတို႔အေထာင္သတင္းေပး။ ေရွာင္တခင္။ ခံစားခ်က္က်ိတ္၍၊မဝံ့တဝံ့ျဖစ္ေနေသာ။ ၁ခ႐ုပ္ရွင္၊ျပပဲြစသည္သီးသန္႔အႀကိဳပဲြ။ အလစ္သုတ္သမား။ တိတ္တဆိတ္ခ်ဥ္းကပ္သြားသည္။ ခိုးေၾကာင္ခိုးဝွက္လုပ္ေသာ၊ျဖစ္ေသာ။||
sneer|v|ေလွာင္သည္။ သေရာ္သည္။ သေရာ္ျပံဳးျပံဳးသည္။ ေလွာင္ရယ္ရယ္သည္။ အထင္ေသးေၾကာင္းကိုျပသည့္အၾကည့္၊အျပံဳး၊အေျပာ၊စကားရပ္စသည္။||
sneeze|n|ႏွာေခ်ျခင္း။ ႏွာေခ်သည္။ ေပါ့ေသးေသးမဟုတ္။||
snicker|v|က်ိတ္ရယ္သည္။ က်ိတ္ရယ္သူ||
snide|adj|မထိတထိ႐ႈတ္ခ်ေသာ။ လက္သီးပုန္းထိုးေသာ။||
sniff|v|ႏွာ႐ႈပ္သည္။ ကရွဴသည္။ နမ္းသည္။ ခႏွာေခါင္းကရွဴသြင္းသည္။ ဂမူးယစ္ေဆးဝါးစသည္ရွဴသည္။ ကငိုမဲ့မဲ့ေျပာသည္။ ခမာနသံႏွင့္၊မႏွစ္သက္ဟန္ႏွင့္မဲ့မဲ့ရြဲ႔ရြဲ႔ေျပာသည္။ ႏွာ႐ႈပ္ျခင္း။ ယင္းအသံ။ တစ္ရွဴ၊တစ္႐ႈိက္။ အနံ႔အသက္ရသည္ႏွင့္။ ဂ႐ုမစိုက္၊အထင္ေသးသည္။ လူရွာေဖြေဖာ္ထုတ္သည္။ အနံ႔ခံေခြး။||
sniffle|v|ႏွာတ႐ႈပ္႐ႈပ္ျဖစ္သည္။ ႏွာ႐ႈပ္ျခင္း။ ႏွာ႐ႈပ္သံ။ အေအးမိသည္။ အေအးပတ္သည္။||
sniffy|adj|ႏွာေခါင္း႐ႈံ႔ေသာ။||
snifter|n|အရက္တစ္ေမာ့။||
snigger|n|ေငါ့၍တိုးတိုးရယ္ျခင္း။ ေလွာင္ရယ္သည္။||
snip|v|ကိုက္သည္။ ညႇပ္သည္။ ကိုက္ျခင္း။ ညႇပ္ျခင္း။ ေလွ်ာ့ေဈး။||
snipe|n|စႏိုက္ငွက္။ ဗိုလ္စားငွက္။ ေခ်ာင္းပစ္သည္။ အပုပ္ခ်သည္။ ေခ်ာင္းပစ္သူ။ လက္ေျဖာင့္။||
snippet|n|သတင္း၊အခ်က္အလက္အတိုအထြာ။||
snivel|v|ကတ႐ႈပ္႐ႈပ္ငိုသည္။ ခညည္းညဴသည္။ ခ်ဴသံပါေအာင္ညည္းေသာ။||
snob|n|ကအထက္ဖားေအာက္ဖိ။ မ်က္ႏွာႀကီးရာဟင္းဖတ္ပါလူစား။ ငဖား။ အနားျပာ။ ခလူတတ္ႀကီး။ ဆရာႀကီး။ ေသြးႀကီးေမြးႀကီးႏိုင္သူ။ ေသြးႀကီးေမြးႀကီးႏိုင္ျခင္း။ ဘဝင္ကိုင္ျခင္း။ ဇီဇာေၾကာင္ေသာ။ ဇီဇာေၾကာင္ျခင္း။||
snog|v|ဖက္နမ္းသည္။ ဖက္နမ္းျခင္း။||
snooker|n|ကဘိလိယက္ခံုေပၚတြင္အနီေဘာလံုးတစ္ဆယ့္ငါးလံုး၊အေရာင္ကဲြေျခာက္လံုးအျဖဴထိုးေဘာတစ္လံုးတို႔ျဖင့္ကစားနည္း။ စႏူကာ။ ၃ခစႏူကာကစားရာ၌ၿပဳိင္ဘက္ထိုးလွည့္တြင္ထိုးေပါက္ပိတ္ေအာင္ထိုးေဘာကိုဆစ္ထားသည့္အေနအထား။ တစ္ဖက္သားထိုးခြင့္မသာေအာင္ဆစ္ထားလိုက္သည္။ ဥခြက်ေအာင္ဆစ္ထားသည္။||
snoop|v|ေခ်ာင္းသည္။ ခိုးၾကည့္သည္။ ေခ်ာင္းၾကည့္သူ။ ခိုးၾကည့္သူ။||
snooty|adj|ေသြးႀကီးေမြးႀကီးႏိုင္ျခင္း။ ဘဝင္ျမင့္ျခင္း။ ေသြးႀကီးေမြးႀကီးႏိုင္ေသာ။ အဖက္မတန္သေဘာထားေသာ။||
snooze|v|တစ္ေရးေမွးသည္။ မွိန္းသည္။ တစ္ေမွးအိပ္ျခင္း။||
snore|v|တေခါေခါႏွင့္ေဟာက္သည္။ ေဟာက္သံ။ ေဟာက္ျခင္း။||
snorkel|n|ေရေအာက္အသက္ရွဴပိုက္။ ယင္းပိုက္ကိုသံုးရသည့္ေရေအာက္အားကစားၿပဳိင္ပဲြ။||
snort|v|ကႏွာမႈတ္သည္။ ႏွာျဖဳပ္သည္။ ခ̏ဟြန္း˝ဟုအသံျပဳ၍သေရာ္သည္၊ေလွာင္သည္၊ေငါ့သည္။ ကိုကင္းရွဴသည္။ ႏွာမႈတ္ျခင္း။ ႏွာမႈတ္သံ။ ကိုးကင္းတစ္႐ႈ၊တစ္႐ႈိက္။||
snot|n|ႏွပ္။ ႏွပ္ေခ်း။ ႏွပ္ေခ်းဖတ္။ ႏွပ္ေခ်းတဲြလဲႏွင့္။ ႏွပ္ထူလပ်စ္ႏွင့္။ မတူမတန္သေဘာျဖင့္တင္စီးေသာ။ ေသြးႀကီးေသာ။ ဟိတ္ႀကီးဟန္ႀကီးလုပ္ေသာ၊ႏိုင္ေသာ။||
snout|n|ႏႈတ္သီး။ ေသနတ္ေျပာင္း။ ႏွာေခါင္း။||
snow|n|ႏွင္း။ ႏွင္းခဲ။ ႏွင္းပြင့္။ ႏွင္း။ ဆီးႏွင္း။ ႏွင္းက်သည္။ လႈိင္းသည္။ ႏွင္းဖံုးေနေသာ။ ႏွင္းလႊမ္းေသာ။ ႏွင္းခိုသည္။ ပိေနသည္။ ႏွင္းလႊမ္း၍ပိတ္ေနသည္။ ဆြတ္ဆြတ္ျဖဴ။ ကႏွင္းဖံုးေနေသာ။ ခႏွင္းက်ေသာ။ ႏွင္းထူေသာ။ ႏွင္းကဲ့သို႔ျဖဴေဖြးေသာ။ ေငြႏွင္းျဖဴ။||
snowball|n|ပစ္ေပါက္ကစားသည့္ႏွင္းေဘာလံုး၊ႏွင္းဆုပ္လံုး။ ခဏခ်င္းႀကီးထြားျခင္း။ တစ္မုဟုတ္ခ်င္းႀကီးထြားျပင္းထန္လာသည္။ ႏွင္းဆုပ္လံုးျဖင့္ပစ္ေပါက္ကစားသည္။||
snowblower|n|ႏွင္းက်ဳံးမႈတ္ဖယ္စက္။||
snowbound|adj|ႏွင္းပိတ္ေနေသာ။||
snowcapped|adj|အထြတ္ကိုႏွင္းလႊမ္းေသာ။||
snowdrift|n|ေလတိုက္၍ျဖစ္ေသာႏွင္းခဲပံု။||
snowdrop|n|ႏွင္းေခါင္းေလာင္းပန္း။||
snowfall|n|ကဆီးႏွင္းက်ျခင္း။ ခက်သည့္ဆီးႏွင္းပမာဏ။||
snowfield|n|အျမဲတမ္းဆီးႏွင္းျပင္။||
snowflake|n|ဆီးႏွင္းပြင့္။||
snowline|n|အျမဲတမ္းဆီးႏွင္းျပင္အနားသတ္မ်ဥ္း။||
snowplough|n|ဆီးႏွင္းရွင္းေဂၚသို႔ယာဥ္||
snowshoe|n|ႏွင္းေတာစီးဖိနပ္။||
snowstorm|n|ႏွင္းမုန္တိုင္း။||
SNP|abbr|စေကာ့တလန္အမ်ဳိးသားပါတီ||
snub|v|ကအဖက္မတန္သလိုဥေပကၡာျပဳသည္သို႔နင့္နာေအာင္ေျပာသည္။ ခဖိတ္ၾကားသည္ကိုအေရးမစိုက္။ ပစ္ပယ္သည္။ ပမာမခန္႔ျပဳျခင္း။ မ်က္ႏွာပ်က္ေအာင္လုပ္ျခင္း။ တို၍ထိပ္လန္ေနေသာႏွာေခါင္း။||
snuff|v|ဖေယာင္းတိုင္မီးကိုၿငႇိမ္းသည္။ ေသသည္။ ၾကြသည္။ ဇီဝိန္ခ်ဳပ္သည္။ သတ္ပစ္သည္။ ႏွာ။||
snuffbox|n|ႏွာဘူး။||
snuffle|v|ကတိရစၦာန္တ႐ႈပ္႐ႈပ္လုပ္သည္။ ခႏွာမႊန္သည္။ ႏွပ္႐ႈပ္သည္။||
